###                 #########
#   ###################   # #
# ####                # #  ##
# ################### # ##B##
#                     # # # #
##################### # # ###
#   ##       #        # # # #
# # ## ### ## ######### # # #
# #    #   ##           # # #
# # ## ################ # # #
### ##             #### # # #
### ############## ## # # # #
###             ##    # # # #
###### ######## ####### # # #
###### ####                 #
      ######### #############
###                 #########
#   ###################   # #
# ####                # # # #
# ################### # # # #
#                     # # # #
##################### # # # #
#   ##                # # # #
# # ## ### ## ######### # # #
# #    #   ###         # # #
# # ## ################ # # #
### ##             #### # # #
### ############## ## # # # #
###             ##    # # # #
###### ######## ####### # # #
###### ####             #   #
A      ######################